W,W,W,W,W,W,W,W,W,W,W,W,W,W,W,W,W,W,W,W,W,W,W,W,W,W
W,,F,F,F,F,,W,,F,F,F,F,F,,,F,F,,,,,,,,W
W,,F,F,F,F,,W,,F,F,KS,F,F,,,F,F,,,,,F,F,F,W
W,,,F,F,,,,,,38,,,,,,,1,,,,,F,F,F,W
W,,,,F,,F,W,,F,F,F,F,F,F,,,F,F,,,,F,F,F,W
W,,,,F,,F,W,,F,,,,F,F,F,F,F,F,,,,F,F,F,W
W,,F,,F,,F,W,,,,,,F,F,F,F,F,F,2,3,2,F,F,F,W
FD,,F,,,1,,W,F,F,,,,,,,,,1,,,,,,,W
W,W,W,W,W,W,W,W,W,W,W,W,W,W,W,W,W,W,W,W,W,W,W,W,W,W